0505050505050505050505050505050505050505050505050505050539000040404040404040404040404040404040404040404040404040404040404040404040404040404040404040404040404040404040404040404040404040404040404040404040404040404040404040404040404040404040404040404040404040404040404040404040404040404040404040404040404040404040390000
0505050505050505050505050505050505050505050505050505050500050505050505050505050505050505050505050505050505050505050505050505050505050505050505050505050505050505050505050505050505050505050505050505050505050505050505050505050505050505050505050505050505050505050505050505050505050505050505050505050505050505050505050500
0505050505050505050505050505050505050505050505050505050500050505050505050505050505050505050505050505050505050505050505050505050505050505050505050505050505050505050505050505050505050505050505050505050505050505050505050505050505050505050505050505050505050505050505050505050505050505050505050505050505050505050505050500
0505050505050505050505050505050505050505050505050505050500050505050505050505050505050505050505050505050505050505050505050505050505050505050505050505050505050505050505050505050505050505050505050505050505050505050505050505050505050505050505050505050505050505050505050505050505050505050505050505050505050505050505050500
0505050505050505050505050505050505050505050505050505050545050505050505050505050505050505050505050505050505050505050505050505050505050505050505050505050505050505050505050505050505050505050505050505050505050505050505050505050505050505050505050505050505050505050505050505050505050505050505050505050505050505050505050545
0505050505050505050505050505050505050505050505050505050545050505050505050505050505050505050505050505050505050505050505050505050505050505050505050505050505050505050505050505050505050505050505050505050505050505050505050505050505050505050505050505050505050505050505050505050505050505050505050505050505050505050505050545
0505050505050505050505050505050505050505050505050505050545050505050505050505050505050505050505050505050505050505050505050505050505050505050505050505050505050505050505050505050505050505050505050505050505050505050505050505050505050505050505050505050505050505050505050505050505050505050505050505050505050505050505050545
0505050505050505050505050505050505050505050505050505050545050505050505050505050505050505050505050505050505050505050505050505050505050505050505050505050505050505050505050505050505050505050505050505050505050505050505050505050505050505050505050505050505050505050505050505050505050505050505050505050505050505050505050545
0505050505050505050505050505050505050505050505050505050545050505050505050505050505050505050505050505050505050505050505050505050505050505050505050505050505050505050505050505050505050505050505050505050505050505050505050505050505050505050505050505050505050505050505050505050505050505050505050505050505050505050505050545
0505050505050505050505050505050505050505050505050505050545050505050505050505050505050505050505050505050505050505050505050505050505050505050505050505050505050505050505050505050505050505050505050505050505050505050505050505050505050505050505050505050505050505050505050505050505050505050505050505050505050505050505050545
0505050505050505050505050505050505050505050505050505050545050505050505050505050505050505050505050505050505050505050505050505050505050505050505050505050505050505050505050505050505050505050505050505050505050505050505050505050505050505050505050505050505050505050505050505050505050505050505050505050505050505050505050545
0505050505050505050505050505050505050505050505050505050545050505050505050505050505050505050505050505050505050505050505050505050505050505050505050505050505050505050505050505050505050505050505050505050505050505050505050505050505050505050505050505050505050505050505050505050505050505050505050505050505050505050505050545
0505050505050505050505050505050505050505050505050505050545050505050505050505050505050505050505050505050505050505050505050505050505050505050505050505050505050505050505050505050505050505050505050505050505050505050505050505050505050505050505050505050505050505050505050505050505050505050505050505050505050505050505050545
0505050505050505050505050505050505050505050505050505050545050505050505050505050505050505050505050505050505050505050505050505050505050505050505050505050505050505050505050505050505050505050505050505050505050505050505050505050505050505050505050505050505050505050505050505050505050505050505050505050505050505050505050545
0505050505050505050505050505050505050505050505050505050545050505050505050505050505050505990505050505050505050505050505050505050505050505050505050505050505050505050505050505050505050505050505050505050505050505050505050505050505050505050505050505050505050505050505050505050505050505050505050505050505050505050505050545
0505050505050505050505050505050505050505050505050505050545050505050505050505050505050505050505050505050505050505050505050505050505050505050505050505050505050505050505050505050505050505050505050505050505050505050505050505050505050505050505050505050505050505050505050505050505050505050505050505050505050505050505050545
0505050505050505050505050505050505050505050505050505050545050505050505050505050505050505640505050505050505050505050505050505050505050505050505050505050505050505050505050505050505050505050505050505050505050505050505050505050505050505050505050505050505050505050505050505050505050505050505050505050505050505050505050545
0505050505050505050505050505050505050505050505050505050545050505050505050505050505050505050505050505050505050505050505050505050505050505050505050505050505050505050505050505050505050505050505050505050505050505050505050505050505050505050505050505050505050505050505050505050505050505050505050505050505050505050505050545
0505050505050505050505050505050505050505050505050505050545050505050505050505050505050505050505050505050505050505050505050505050505050505050505050505050505050505050505050505050505050505050505050505050505050505050505050505050505050505050505050505050505050505050505050505050505050505050505050505050505050505050505050545
0505050505050505050505050505050505050505050505050505050545050505050505050505050505050505050505050505050505050505050505050505050505050505050505050505050505050505050505050505050505050505050505050505050505050505050505050505050505050505050505050505050505050505050505050505050505050505050505050505050505050505050505050545
0505050505050505050505050505050505050505050505050505050545050505050505050505050505050505050505050505050505050505050505050505050505050505050505050505050505050505050505050505050505050505050505050505050505050505050505050505050505050505050505050505050505050505050505050505050505050505050505050505050505050505050505050545
0505050505050505050505050505050505050505050505050505050545050505050505050505050505050505050505050505050505050505050505050505050505050505050505050505050505050505050505050505050505050505050505050505050505050505050505050505050505050505050505050505050505050505050505050505050505050505050505050505050505050505050505050545
0505050505050505050505050505050505050505050505050505050545050505050505050505050505050505050505050505050505050505050505050505050505050505050505050505050505050505050505050505050505050505050505050505050505050505050505050505050505050505050505050505050505050505050505050505050505050505050505050505050505050505050505050545
0505050505050505050505050505050505050505050505050505050545050505050505050505050505050505050505050505050505050505050505050505050505050505050505050505050505050505050505050505050505050505050505050505050505050505050505050505050505050505050505050505050505050505050505050505050505050505050505050505050505050505050505050545
0505050505050505050505050505050505050505050505050505050545050505050505050505050505050505050505050505050505050505050505050505050505050505050505050505050505050505050505050505050505050505050505050505050505050505050505050505050505050505050505050505050505050505050505050505050505050505050505050505050505050505050505050545
0505050505050505050505050505050505050505050505050505050545050505050505050505050505050505050505050505050505050505050505050505050505050505050505050505050505050505050505050505050505050505050505050505050505050505050505050505050505050505050505050505050505050505050505050505050505050505050505050505050505050505050505050545
0505050505050505050505050505050505050505050505050505050545050505050505050505050505050505050505050505050505050505050505050505050505050505050505050505050505050505050505050505050505050505050505050505050505050505050505050505050505050505050505050505050505050505050505050505050505050505050505050505050505050505050505050545
0505050505050505050505050505050505050505050505050505050545050505050505050505050505050505050505050505050505050505050505050505050505050505050505050505050505050505050505050505050505050505050505050505050505050505050505050505050505050505050505050505050505050505050505050505050505050505050505050505050505050505050505050545
0505050505050505050505050505050505050505050505050505050545050505050505050505050505050505050505050505050505050505050505050505050505050505050505050505050505050505050505050505050505050505050505050505050505050505050505050505050505050505050505050505050505050505050505050505050505050505050505050505050505050505050505050545
0505050505050505050505050505050505050505050505050505050545050505050505050505050505050505050505050505050505050505050505050505050505050505050505050505050505050505050505050505050505050505050505050505050505050505050505050505050505050505050505050505050505050505050505050505050505050505050505050505050505050505050505050545
0505050505050505050505050505050505050505050505050505050545050505050505050505050505050505050505050505050505050505050505050505050505050505050505050505050505050505050505050505050505050505050505050505050505050505050505050505050505050505050505050505050505050505050505050505050505050505050505050505050505050505050505050545
0505050505050505050505050505050505050505050505050505050545050505050505050505050505050505050505050505050505050505050505050505050505050505050505050505050505050505050505050505050505050505050505050505050505050505050505050505050505050505050505050505050505050505050505050505050505050505050505050505050505050505050505050545
0505050505050505050505050505050505050505050505050505050545050505050505050505050505050505050505050505050505050505050505050505050505050505050505050505050505050505050505050505050505050505050505050505050505050505050505050505050505050505050505050505050505050505050505050505050505050505050505050505050505050505050505050545
0505050505050505050505050505050505050505050505050505050545050505050505050505050505050505050505050505050505050505050505050505050505050505050505050505050505050505050505050505050505050505050505050505050505050505050505050505050505050505050505050505050505050505050505050505050505050505050505050505050505050505050505050545
0505050505050505050505050505050505050505050505050505050545050505050505050505050505050505050505050505050505050505050505050505050505050505050505050505050505050505050505050505050505050505050505050505050505050505050505050505050505050505050505050505050505050505050505050505050505050505050505050505050505050505050505050545
0505050505050505050505050505050505050505050505050505050545050505050505050505050505050505050505050505050505050505050505050505050505050505050505050505050505050505050505050505050505050505050505050505050505050505050505050505050505050505050505050505050505050505050505050505050505050505050505050505050505050505050505050545
0505050505050505050505050505050505050505050505050505050545050505050505050505050505050505050505050505050505050505050505050505050505050505050505050505050505050505050505050505050505050505050505050505050505050505050505050505050505050505050505050505050505050505050505050505050505050505050505050505050505050505050505050545
0505050505050505050505050505050505050505050505050505050539050505050505050505050505050505050505050505050505050505050505050505050505050505050505050505050505050505050505050505050505050505050505050505050505050505050505050505050505050505050505050505050505050505050505050505050505050505050505050505050505050505050505050545
0505050505050505050505050505050505050505050505050505050500000040404040404040404040404005050505050540404040404040404040404040390505050505050505050505050505050505050505050505050505050505050505050505050505050505050505050505050505050505050505050505050505050505050505050505050505050505050505050505050505050505050505050545
0505050505050505050505050505050505050505050505050505050500001212121212121212121212120505050505050505121212121212121212121212121205050505050505050505050505050505050505050505050505050505050505050505050505050505050505050505050505050505050505050505050505050505050505050505050505050505050505050505050505050505050505050545
0505050505050505050505050505050505050505050505050505050545121212121212121212121212120505050505050505121212121212121212121212121205050505050505050505050505050505050505050505050505050505050505050505050505050505050505050505050505050505050505050505050505050505050505050505050505050505050505050505050505050505050505050545
0505050505050505050505050505050505050505050505050505050545121212121212121212121212121202050505050812121212121212121212121212121245050505050505050505050505050505050505050505050505050505050505050505050505050505050505050505050505050505050505050505050505050505050505050505050505050505050505050505050505050505050505050545
0505050505050505050505050505050505050505050505050505050545121212121212121212121212121202050505050812121212121212121212121212121245050505050505050505050505050505050505050505050505050505050505050505050505050505050505050505050505050505050505050505050505050505050505050505050505050505050505050505050505050505050505050545
0505050505050505050505050505050505050505050505050505050545121212121212121212121212121202050505050812121212341212121212121212121245050505050505050505050505050505050505050505050505050505050505050505050505050505050505050505050505050505050505050505050505050505050505050505050505050505050505050505050505050505050505050545
0505050505050505050505050505050505050505050505050505050545121212331212121212123312121202050505050812121212121212121212121212121245050505050505050505050505050505050505050505050505050505050505050505050505050505050505050505050505050505050505050505050505050505050505050505050505050505050505050505050505050505050505050545
0505050505050505050505050505050505050505050505050505050545121212121212121212121212121202050505050812121212121212121212121212121245050505050505050505050505050505050505050505050505050505050505050505050505050505050505050505050505050505050505050505050505050505050505050505050505050505050505050505050505050505050505050545
0505050505050505050505050505050505050505050505050505050545121212121212121212121212121202050505050812121212121212121212121212121245050505050505050505050505050505050505050505050505050505050505050505050505050505050505050505050505050505050505050505050505050505050505050505050505050505050505050505050505050505050505050545
0505050505050505050505050505050505050505050505050505050545121212121212121212121212121202050505050812121212121212121212121212121245050505050505050505050505050505050505050505050505050505050505050505050505050505050505050505050505050505050505050505050505050505050505050505050505050505050505050505050505050505050505050545
0505050505050505050505050505050505050505050505050505050545121212121212121212121212121202050505050812121212121212121212121212121245050505050505050505050505050505050505050505050505050505050505050505050505050505050505050505050505050505050505050505050505050505050505050505050505050505050505050505050505050505050505050545
0505050505050505050505050505050505050505050505050505050545121212121212121212121212121202050505050812121212121212121212121212121245050505050505050505050505050505050505050505050505050505050505050505050505050505050505050505050505050505050505050505050505050505050505050505050505050505050505050505050505050505050505050545
0505050505050505050505050505050505050505050505050505050545121212331212121212123312121202050505050812121212341212121212121212121245050505050505050505050505050505050505050505050505050505050505050505050505050505050505050505050505050505050505050505050505050505050505050505050505050505050505050505050505050505050505050545
0505050505050505050505050505050505050505050505050505050545121212121212121212121212121202050505050812121212121212121212121212121245050505050505050505050505050505050505050505050505050505050505050505050505050505050505050505050505050505050505050505050505050505050505050505050505050505050505050505050505050505050505050545
0505050505050505050505050505050505050505050505050505050545121212121212121212121212121202050505050812121212121212121212121212121245050505050505050505050505050505050505050505050505050505050505050505050505050505050505050505050505050505050505050505050505050505050505050505050505050505050505050505050505050505050505050545
0505050505050505050505050505050505050505050505050505050545121212121212121212121212121202050505050812121212121212121212121212121245050505050505050505050505050505050505050505050505050505050505050505050505050505050505050505050505050505050505050505050505050505050505050505050505050505050505050505050505050505050505050545
0505050505050505050505050505050505050505050505050505050545121212121212121212121212121202050505050812121212121212121212121212121245050505050505050505050505050505050505050505050505050505050505050505050505050505050505050505050505050505050505050505050505050505050505050505050505050505050505050505050505050505050505050545
0505050505050505050505050505050505050505050505050505050545121212121212121212121212121202050505050812121212121212121212121212121245050505050505050505050505050505050505050505050505050505050505050505050505050505050505050505050505050505050505050505050505050505050505050505050505050505050505050505050505050505050505050545
0505050505050505050505050505050505050505050505050505050545121212121212121212121212121202050505050812121212121212121212121212121245050505050505050505050505050505050505050505050505050505050505050505050505050505050505050505050505050505050505050505050505050505050505050505050505050505050505050505050505050505050505050545
0505050505050505050505050505050505050505050505050505050545121212121212121212121212121202050505050812121212341212121212121212121245050505050505050505050505050505050505050505050505050505050505050505050505050505050505050505050505050505050505050505050505050505050505050505050505050505050505050505050505050505050505050545
0505050505050505050505050505050505050505050505050505050545123112123112123112123112121202050505050812121212121212121212121212121245050505050505050505050505050505050505050505050505050505050505050505050505050505050505050505050505050505050505050505050505050505050505050505050505050505050505050505050505050505050505050545
0505050505050505050505050505050505050505050505050505050545121212121212121212121212121202050505050812121212121212121212121212121245050505050505050505050505050505050505050505050505050505050505050505050505050505050505050505050505050505050505050505050505050505050505050505050505050505050505050505050505050505050505050545
0505050505050505050505050505050505050505050505050505050545121212121212121212121212120105050505050507121212121212121212121212121245050505050505050505050505050505050505050505050505050505050505050505050505050505050505050505050505050505050505050505050505050505050505050505050505050505050505050505050505050505050505050545
0505050505050505050505050505050505050505050505050505050545040404040404040404040404040505050505050505040404040404040404040404040445050505050505050505050505050505050505050505050505050505050505050505050505050505050505050505050505050505050505050505050505050505050505050505050505050505050505050505050505050505050505050545
0505050505050505050505050505050505050505050505050505050545050505050505050505050505050505050505050505050505050505050505050505050545050505050505050505050505050505050505050505050505050505050505050505050505050505050505050505050505050505050505050505050505050505050505050505050505050505050505050505050505050505050505050545
0505050505050505050505050505050505050505050505050505050545050505050505050505050505050505050505050505050505050505050505050505050545050505050505050505050505050505050505050505050505050505050505050505050505050505050505050505050505050505050505050505050505050505050505050505050505050505050505050505050505050505050505050545
0505050505050505050505050505050505050505050505050505050545060606060606060606060606060505050505050505060606060606060606060606060645050505050505050505050505050505050505050505050505050505050505050505050505050505050505050505050505050505050505050505050505050505050505050505050505050505050505050505050505050505050505050545
0505050505050505050505050505050505050505050505050505050545121212121212121212121212120305050505050509121212121212121212121212121245050505050505050505050505050505050505050505050505050505050505050505050505050505050505050505050505050505050505050505050505050505050505050505050505050505050505050505050505050505050505050545
0505050505050505050505050505050505050505050505050505050545121212121212121212121212121202050505050812121212121212121212121212121245050505050505050505050505050505050505050505050505050505050505050505050505050505050505050505050505050505050505050505050505050505050505050505050505050505050505050505050505050505050505050545
0505050505050505050505050505050505050505050505050505050545121212121212121212121212121202050505050812121235121212121212123512121245050505050505050505050505050505050505050505050505050505050505050505050505050505050505050505050505050505050505050505050505050505050505050505050505050505050505050505050505050505050505050545
0505050505050505050505050505050505050505050505050505050545121232121212121212321212121202050505050812121212121212121212121212121245050505050505050505050505050505050505050505050505050505050505050505050505050505050505050505050505050505050505050505050505050505050505050505050505050505050505050505050505050505050505050545
0505050505050505050505050505050505050505050505050505050545121212121212121212121212121202050505050812121212121212121212121212121245050505050505050505050505050505050505050505050505050505050505050505050505050505050505050505050505050505050505050505050505050505050505050505050505050505050505050505050505050505050505050545
0505050505050505050505050505050505050505050505050505050545121212121212121212121212121202050505050812121212121212121212121212121245050505050505050505050505050505050505050505050505050505050505050505050505050505050505050505050505050505050505050505050505050505050505050505050505050505050505050505050505050505050505050545
0505050505050505050505050505050505050505050505050505050545121212121212121212121212121202050505050812121212121212121212121212121245050505050505050505050505050505050505050505050505050505050505050505050505050505050505050505050505050505050505050505050505050505050505050505050505050505050505050505050505050505050505050545
0505050505050505050505050505050505050505050505050505050545121212121212121212121212121202050505050812121212121212121212121212121245050505050505050505050505050505050505050505050505050505050505050505050505050505050505050505050505050505050505050505050505050505050505050505050505050505050505050505050505050505050505050545
0505050505050505050505050505050505050505050505050505050539121212121212121212121212121202050505050812121212121212121212121212390505050505050505050505050505050505050505050505050505050505050505050505050505050505050505050505050505050505050505050505050505050505050505050505050505050505050505050505050505050505050505390000
0505050505050505050505050505050505050505050505050505050505121212121212121212121212121202050505050812121212121212121212121212050505050505050505050505050505050505050505050505050505050505050505050505050505050505050505050505050505050505050505050505050505050505050505050505050505050505050505050505050505050505050505050505
0505050505050505050505050505050505050505050505050505050505121212121212121212121212121202050505050812121212121212121212121212050505050505050505050505050505050505050505050505050505050505050505050505050505050505050505050505050505050505050505050505050505050505050505050505050505050505050505050505050505050505050505050505
0505050505050505050505050505050505050505050505050505050500000040404040404040404040404040404040404040404040404040404040404040000000404040404040404040404040404040404040404040404040404040404040404040404040404040404040404040404040404040404040404040404040404040404040404040404040404040404040404040404040404040404040000000



