3900004040404040404040404040404040404040404040404040404040404040404040404040404040404040404040404040404040404040390000
0020202020202020202020202020202020202020202020202020202020202020202020202020202020202020202020202020202020202020202000
0020202020202020202020202020202020202020202020202020202020202020202020202020202020202020202020202020202020202020202000
0020202020202020202020202020202020202020202020202020202020202020202020202020202020202020202020202020202020202020202000
4520202020202020202020202020202020202020202020202020202020202020202020202020202020202020202020202020202020202020202045
4520202020202020202020202020202020202020202020202020202020202020202020202020202020202020202020202020202020202020202045
4520202020202020202020202020202020202020202020202020202020202020202020202020202020202020202020202020202020202020202045
4520202020202020202020202020202020202020202020202020202020202020202020202020202020202020202020202020202020202020202045
4520202020202020202020202020202020202020202020202020202020202020202020202020202020202020202020202020202020202020202045
4520202020202020202020202020202020202020202020202020202020202020202020202020202020202020202020202020202020202020202045
4520202020202020202020202020202020202020202020202020202020202020202020202020202020202020202020202020202020202020202045
4520202020202020202020202020202020202020202020202020202020202020202020202020202020202020202020202020202020202020202045
4520202020202020202020202020202020202020202020202020202020202020202020202020202020202020202020202020202020202020202045
4520202020202020202020202020202020202020202020202020202020202020202020202020202020202020202020202020202020202020202045
4520202020202020202020202020202020202020202020202020202020202020202020202020202020202020202020202020202020202020202045
4520202020202020202020202020202020202020202020202020202020202020202020202020202020202020202020202020202020202020202045
4520202020202020202020202020202020202020202020202020202020202020202020202020202020202020202020202020202020202020202045
4520202020202020202020202020202020202020202020202020202020202020202020202020202020202020202020202020202020202020202045
4520202020202020202020202020202020202020202020202020202020202020202020202020202020202020202020202020202020202020202045
4520202020202020202020202020202020202020202020202020202020202020202020202020202020202020202020202020202020202020202045
4520202020202020202020202020202020202020202020202020202020202020202020202020202020202020202020202020202020202020202045
4520202020202020202020202020202020202020202020202020202020202020202020202020202020202020202020202020202020202020202045
4520202020202020202020202020202020202020202020202020202020202020202020202020202020202020202020202020202020202020202045
3920202020202020202020202020202020202020202020202020202020202020202020202020202020202020202020202020202020202020390000
2020202020202020202020202020202020202020202020202020202020202020202020202020202020202020202020202020202020202020202020
2020202020202020202020202020202020202020202020202020202020202020202020202020202020202020202020202020202020202020202020
0000004040404040404040404040404040404040404040404040404040404040404040404040404040404040404040404040404040404040000000